{
    "levels": [
        {
            "map": [
                "                                         ",
                "                                         ",
                "                                         ",
                "                                         ",
                "                   S                     ",
                "     #  K   G    ##                      ",
                "     ############                        ",
                "                        #                ",
                "                                         ",
                "               CC              #         ",
                "   &      ?%                             ",
                "      M                 G                ",
                "               %            K#    K     #",
                "##########################################"
            ]
        }
    ]
}
