{
    "levels": [
        {
            "map": [
                "                                         ",
                "                                         ",
                "                                         ",
                "                                         ",
                "                                         ",
                "                                         ",
                "                                         ",
                "                                         ",
                "                                         ",
                "           P   CC              #         ",
                "   &      =                              ",
                "      M   |             G                ",
                "          |    %            K#    K     #",
                "##########################################"
            ]
        }
    ]
}
