{
    "levels": [
        {
            "map": [
                "                                         ",
                "                                         ",
                "                                         ",
                "                                         ",
                "                   S                     ",
                "     #  K   G    ##                      ",
                "     ############                        ",
                "                 #      #                ",
                "             #   ########                ",
                "          S                    #         ",
                "          #                     #        ",
                "      M                 G                ",
                "                #           K#    K     #",
                "##########################################"
            ]
        }
    ]
}
