{
    "levels": [
        {
            "map": [
                "                                                   ",
                "                                                   ",
                "                                                   ",
                "                                                   ",
                "                                                   ",
                "                                                   ",
                "         R                                         ",
                "        %%              p                          ",
                "                                       G           ",
                "      R    P   CC                      #           ",
                "   &%%%   =                                        ",
                "      M   |                                        ",
                "          |                 R   % K     #      F   ",
                "############### ############# ######################"
            ],
            "groundColor": [175, 118, 10],
            "topGroundColor": [57, 175, 14],
            "background": 0
        }
    ]
}
