{
    "levels": [
        {
            "map": [
                "                                   ",
                "                                   ",
                "                                   ",
                "                                   ",
                "                                   ",
                "                                   ",
                "                     K             ",
                "                 #      #          ",
                "             #   ########          ",
                "                                   ",
                "          #                        ",
                "      M                 G          ",
                "                #            #     ",
                "###################################"
            ]
        }
    ]
}
