{
    "levels": [
        {
            "map": [
                "                                                   ",
                "                                                   ",
                "                                                   ",
                "                                                   ",
                "                                                   ",
                "                                                   ",
                "                                                   ",
                "                                                   ",
                "                                                   ",
                "           P   CC              #                   ",
                "   &      =                                        ",
                "      M   |             G                          ",
                "          |    %            K#    K     #      F   ",
                "####################################################"
            ],
            "groundColor": [175, 118, 10],
            "topGroundColor": [57, 175, 14],
            "background": 0
        }
    ]
}
